_,_,M,M,M,M,M,_
M,M,M,V,V,V,M,_
M,D,J,C,V,V,M,_
M,M,M,V,C,D,M,_
M,D,M,M,C,V,M,_
M,V,M,V,D,V,M,M
M,C,V,R,C,C,D,M
M,V,V,V,D,V,V,M
M,M,M,M,M,M,M,M