M,M,M,M,M,M,M,M,M,M,M,M,_,_
M,D,D,V,V,M,V,V,V,V,V,M,M,M
M,D,D,V,V,M,V,C,V,V,C,V,V,M
M,D,D,V,V,M,C,M,M,M,M,V,V,M
M,D,D,V,V,V,V,J,V,M,M,V,V,M
M,D,D,V,V,M,V,M,V,V,C,V,M,M
M,M,M,M,M,M,V,M,M,C,V,C,V,M
_,_,M,V,C,V,V,C,V,C,V,C,V,M
_,_,M,V,V,V,V,M,V,V,V,V,V,M
_,_,M,M,M,M,M,M,M,M,M,M,M,M