_,M,M,M,M,M,M,M,M,M,M,M,M,M,M,M,M,M,_
_,M,D,D,D,V,V,V,M,V,V,V,V,M,V,V,V,M,M
M,M,D,D,D,D,D,V,V,C,M,M,V,M,V,M,C,V,M
M,D,D,D,D,D,D,M,V,V,C,V,V,M,V,V,V,V,M
M,D,D,D,D,D,D,M,V,V,M,V,V,M,V,M,V,V,M
M,M,M,M,M,M,M,M,M,V,C,V,V,C,V,C,V,V,M
_,_,M,V,V,V,V,V,M,C,M,M,C,V,M,M,C,M,M
_,M,M,V,V,V,C,V,V,V,V,M,V,C,V,V,V,V,M
_,M,V,V,M,M,V,M,M,M,V,M,V,V,M,M,C,V,M
_,M,V,C,V,C,C,V,V,V,V,V,C,V,V,C,V,V,M
_,M,V,C,V,V,V,V,C,M,M,C,V,M,M,M,M,M,M
_,M,M,M,M,M,M,M,V,V,J,V,M,M,_,_,_,_,_
_,_,_,_,_,_,_,M,M,M,M,M,M,_,_,_,_,_,_