_,_,_,_,M,M,M,M,M,_,_,_,_,_,_,_,_,_,_
_,_,_,_,M,V,V,V,M,_,_,_,_,_,_,_,_,_,_
_,_,_,_,M,C,V,V,M,_,_,_,_,_,_,_,_,_,_
_,_,M,M,M,V,V,C,M,M,_,_,_,_,_,_,_,_,_
_,_,M,V,V,C,V,C,V,M,_,_,_,_,_,_,_,_,_
M,M,M,V,M,V,M,M,V,M,_,_,_,M,M,M,M,M,M
M,V,V,V,M,V,M,M,V,M,M,M,M,M,V,V,D,D,M
M,V,C,V,V,C,V,V,V,V,V,V,V,V,V,V,D,D,M
M,M,M,M,M,V,M,M,M,V,M,J,M,M,V,V,D,D,M
_,_,_,_,M,V,V,V,V,V,M,M,M,M,M,M,M,M,M
_,_,_,_,M,M,M,M,M,M,M,_,_,_,_,_,_,_,_